1111111111111
1020101000001
1110101010111
1010001010001
1211101110101
1000100000201
1011101110121
1000200010101
1111111111111