1111111111111
1010102000001
1210101010111
1020001010001
1111101110101
1000200000101
1011101110111
1000100010201
1111111111111