111111111111111111111
101020100010000010201
101110101010111111101
100000001010200000001
101111101011101111111
101000000020002010001
121110111010111011101
101000201010001020001
111111111111111111111