111111111111111111111
101010100020000010101
101210101010111212101
100000001010100000001
101122201011101111221
101000000020001010001
121110111010111011101
101000101020002010001
111111111111111111111